1110000011010101
1110000000010101
0000000000010101
0000000000010101
0000000000010101
0000010000010101
0000010000010101
0000010000010101
0000010000010101
0000010000010101
0000010000010101
0000010000010101
1111111111111111
1111111111111111